#######################
#@                   $#
# ###  #  #   #  # #  #
# ###  # ### ### # ## #
# ###  #  #   #  # #  #
#      #              #
# ## ##### # ####  ## #
#               ##  # #
## #### # ###   #     #
#  #      #   #### ## #
# ### # #####       # #
#  ##     ##  ##  #   #
#  #      #   ##  #   #
##   ###  # #    ###  #
## # ###  # ####  #   #
##   ###            # #
####     ##  ##### ## #
#     ##  #    #      #
# ###  #     # # ###  #
#        ###   #      #
# ###  #  #  #   ###  #
#$    ###   ###      $#
#######################
